1111111111
10PP0E00C1
1111111111
